kandi: ka n di
kartoška: kar to š ka
loli: loli
kartoškaba: kar to š kaba
mokun: mo kun
zor: zor
bocɣol: boc ɣo l
uže: uže
išetlo: iše t lo
liʎe: liʎe
ʎisi: ʎisi
bečin: bečin
hos: hos
biskinab: bis kina b
užen: u žen
obun: obun
išeti: iše ti
bušne: buš ne
biše: biše
goli: goli
idu: idu
ɣine: ɣine
iló: il ó
toxtur: to x tur
yeči: yeči
užá: užá
qodoqo: qodo qo
lak: la k
lexi: le xi
de: de
užala: uža la
kanta: ka n ta
lekʷi: lekʷi
isxin: isxin
hobože: hobo ž e
xani: xani
izzuqo: i zzuqo
židułi: židułi
hečče: heč če
hunar: hunar
gollu: gol lu
žiko: žiko
hibok: hi bo k
ʎɨn: ʎɨn
qˤeyi: qˤe yi
ɣonos: ɣonos
qˤʷelʲ: qˤ ʷe lʲ
xˤuxˤi: xˤu xˤi
cana: ca na
box: bo x
laci: laci
ise: ise
xexiłin: xe xi łin
yuⁿqun: yuⁿ qun
yaška: ya š ka
obuti: obuti
lɨdo: lɨdo
bɨtxi: bɨ t xi
emmo: em mo
megan: me gan
megun: me gun
øuwoxi: øu woxi
hada: hada
žikos: žikos
eⁿs: eⁿ s
bɨtxin: bɨ t xin
bečɨn: beč ɨn
yuqˤqˤu: yuqˤ qˤu
yeklun: ye k lun
čamasseklo: čamasse k lo
hastinamali: has tinamali
obutɨs: obu tɨs
tubi: tu bi
ɨs: ɨs
žuliklo: žuli k lo
tuqˤ: tuqˤ
haʎi: haʎi
iłe: iłe
muše: muše
gollo: gol lo
sapunoz: sa puno z
usanun: usa nun
yuqˤuče: yuqˤu če
qˤʷanaɣaužaz: qˤ ʷa na ɣa uža z
calida: calida
biqdow: bi q dow
utana: u ta na
kaɣataʎa: ka ɣataʎa
kˤabˤa: kˤab ˤ a
šaqiz: šaqi z
qʷagu: qʷa gu
xat: xat
beči: beči
bucoz: bu co z
ɣudul: ɣu dul
neži: neži
bucod: bucod
hobonezi: hobone zi
leʎʎu: leʎʎu
žu: žu
eⁿłala: eⁿła la
ʎolol: ʎolo l
øahlunay: øa h lunay
buxle: bu x le
hadamiyu: hadam i yu
dilʲlʲo: dilʲ lʲo
ezel: eze l
himon: himon
neʎun: ne ʎun
leɣo: le ɣo
dubʎeru: dub ʎe ru
don: don
šuki: šuki
dilʲin: dilʲ in
os: os
boqi: bo qi
ono: ono
ɣonoʎo: ɣonoʎo
heⁿhe: heⁿhe
bečun: bečun
øotqi: øo t qi
mandžuriyaʎa: man d žuri yaʎa
øečču: øeč ču
pulemetčik: puleme t či k
ručnoy: ru č noy
lolbon: lo l bon
luwōxun: lu w ō xun
ɣonʎo: ɣon ʎo
ʎʷade: ʎ ʷa de
ʎolo: ʎolo
ɣʷade: ɣʷa de
užaʎa: užaʎa
co: co
muħamad: mu ħ ama d
lečun: lečun
uⁿqelaʎa: uⁿ qe laʎa
iʎo: iʎo
iʎin: iʎin
bazargani: ba zar gani
caq: caq
isuʎo: isu ʎo
bužun: bužun
yečun: yečun
kandɨl: ka n d ɨl
lokoʎo: lo koʎo
leči: leči
qurban: qur ban
nazirʎozin: na zi r ʎozin
lebalaw: le ba law
iso: iso
xuy: xu y
tuqqu: tuqqu
ʎarla: ʎar la
ɣiná: ɣin á
lacalas: laca las
podnos: po d nos
karavatɨʎ: kara v atɨ ʎ
gɨł: gɨ ł
gulun: gulun
øotqun: øo t qun
nartaw: nar taw
hobołe: hobo łe
ɣonoʎ: ɣonoʎ
izzuč: i zzu č
xanla: xan la
loluʎ: lo lu ʎ
muhubo: mu hu bo
dudun: dudun
soyroʎ: soyroʎ
iʎʎu: iʎʎu
bahan: baha n
tuʎun: tu ʎun
raziłokun: razi ło kun
obu: obu
nartawi: nar taw i
bercinayin: be r cinayin
yoɣo: yoɣo
mo: mo
aqɨʎ: aq ɨ ʎ
roqqun: ro qqun
dilʲ: dilʲ
goqi: go qi
kad: ka d
idun: idun
exenamaɣul: e xenama ɣul
kulun: kulun
yoⁿka: yoⁿ ka
yequn: yequn
łiłuka: łi łuka
hadqal: had qa l
ze: ze
gˤandamal: gˤandamal
qˤem: qˤem
lešto: leš to
isul: isul
bakun: ba kun
łeł: łeł
gił: gi ł
eⁿš: eⁿ š
leštɨn: leštɨn
liʎan: liʎa n
boqunay: boqunay
armił: ar m i ł
øoⁿki: øoⁿ ki
ilʲó: ilʲ ó
qʷinequn: qʷinequn
łino: łino
hobode: hobo de
aʎazi: aʎa zi
hobotun: hobo tun
homonu: homonu
huⁿnzał: huⁿ n za ł
bɨʎɨn: bɨ ʎɨn
posun: posun
ɣolon: ɣolon
ihoʎun: ihoʎun
xristanba: x ris ta n ba
do: do
aʎa: aʎa
aʎał: aʎał
loʎonuqa: loʎonuqa
iłes: iłe s
aq: aq
titihú: ti ti h ú
bezun: be zun
eⁿču: eⁿ ču
ečuł: eču ł
hadal: hadal
iłelo: iłelo
kakaqan: ka kaqan
yoⁿcun: yoⁿ cun
oⁿčeč: oⁿ čeč
huhon: hu hon
yezun: ye zun
qˤbinequn: qˤ binequn
uⁿqeiʎʎo: uⁿ qe iʎʎo
ʎibał: ʎiba ł
gočidoki: go či doki
čačanza: ča ča n za
uⁿqeiʎʎuł: uⁿ qe iʎʎu ł
mičahab: m i ča ha b
ahlus: a h lus
olaʎa: o laʎa
yeɣše: ye ɣ še
ʎun: ʎun
bequn: be qun
haquqala: haquqa la
isuho: isu ho
yoⁿkun: yoⁿ kun
abaxar: a ba xar
yuqˤučeɣolin: yuqˤu če ɣolin
uqˤučeɣolin: uqˤu če ɣolin
iłeɣol: iłe ɣo l
madaul: ma da ul
yešto: yeš to
tɨkan: tɨ ka n
baqˤqˤun: baqˤ qˤun
isuɣo: isu ɣo
puho: pu ho
beɣun: be ɣun
zorʎozi: zor ʎozi
qoʎu: qoʎu
bičin: bi čin
qˤʷanaɣal: qˤ ʷa na ɣal
bog: bo g
boło: bo ło
boloqol: bo lo qo l
boco: boco
łuɣaʎa: łu ɣaʎa
goʎun: goʎun
zori: zori
emqo: em qo
me: me
diqo: diqo
dubo: dubo
nucahar: nu ca har
liʎ: liʎ
nasak: nasa k
ʎin: ʎin
boci: boci
isulo: isulo
tɨrmoqol: tɨ r mo qo l
gɨcaʎa: gɨ caʎa
øuʎun: øu ʎun
babaqa: ba baqa
babas: ba bas
qˤoʎaqaz: qˤ oʎaqa z
ɣayin: ɣayin
boki: bo ki
mariyamqa: mari yam qa
tu: tu
bičli: bi č li
hed: he d
ibrahimi: i b ra hi m i
lʲoʎxun: lʲoʎ xun
užaqa: užaqa
hiboqe: hi bo qe
liyalu: liyalu
aʎałɣul: aʎał ɣul
osun: osun
øoⁿka: øoⁿka
gobi: gobi
calin: ca lin
leqbi: leqbi
dublo: dub lo
mˤaʎeqo: mˤ aʎe qo
eⁿqˤo: eⁿ qˤ o
łiłuká: łi łuk á
abaxari: abaxari
mocun: mo cun
kode: ko de
ɣonoqol: ɣono qo l
leɣun: le ɣun
exenaban: e xena ban
omˤoqˤeʎozi: o mˤ o qˤe ʎozi
bočkamal: bo č kamal
kukkun: kuk kun
čaʎun: čaʎun
qudu: qu du
øečun: øečun
botqun: bo t qun
eⁿšɣoli: eⁿ š ɣoli
øoⁿkun: øoⁿ kun
obutɣoul: obu t ɣo ul
bulhun: bul hun
øuhuqarʎa: øu huqar ʎa
mižul: m i žul
žibžibis: žibžibis
con: con
qʷayin: qʷayin
iⁿyayun: iⁿ yayun
ɣonołul: ɣono łul
zabaykalskiy: zabay ka l s ki y
huⁿne: huⁿne
ʎibirʎoɣul: ʎibi r ʎo ɣul
beqdow: be q dow
ħažiyaw: ħ a ži yaw
øoⁿkše: øoⁿ kše
iseiso: ise iso
omˤoqˤen: o mˤ o qˤen
gˤanun: gˤanun
awlaqʎazi: aw laq ʎa zi
ʎihol: ʎiho l
aⁿka: aⁿ ka
leqquč: leqqu č
qarpuzamazi: qarpuzama zi
mˤgɣul: mˤ g ɣul
qˤe: qˤe
koʎi: koʎi
ʎultani: ʎul ta ni
welesiped: we le si ped
kazaxstanʎaz: ka za x s ta n ʎa z
neqqu: neqqu
diɣol: diɣol
iʎše: iʎše
ilʲul: ilʲul
mokoʎoɣužaz: mo koʎo ɣuža z
moka: mo ka
huⁿnecin: huⁿne cin
ɨsnaza: ɨs na za
aqɣa: aq ɣa
øotqaʎa: øo tqaʎa
giłɣul: gi ł ɣul
øeqba: øe q ba
atɣul: atɣul
akamaužaz: a kamaužaz
gucun: gu cun
qodoɣoqa: qodo ɣo qa
nežžu: než žu
ɣon: ɣon
ʎunʎoqa: ʎun ʎo qa
lotqun: lo t qun
ʎoboʎoqa: ʎo boʎo qa
ílʲo: í lʲo
iłełqa: iłeł qa
hˤamˤaɣˤé: h ˤ amˤ a ɣˤ é
bežta: be ž ta
aumru: aumru
koʎoqoqa: koʎo qo qa
ɨʎo: ɨ ʎo
iqqoɣul: i q qo ɣul
moki: mo ki
avaliɣužaz: a v a li ɣuža z
qala: qa la
ihoʎdow: ihoʎ dow
bogožes: bo go žes
koʎožes: koʎo žes
moko: mo ko
bakše: bakše
koʎoqoso: koʎo qoso
geq: geq
koʎoqo: koʎo qo
yeča: yeča
diyo: di yo
øuxala: øu xa la
yuqˤuso: yuqˤuso
yotqi: yo t qi
øogu: øo gu
yogu: yo gu
bogu: bo gu
zihe: zihe
logu: lo gu
lože: lo ž e
ʎib: ʎib
boguta: bo gu ta
žikobo: žiko bo
loguta: lo gu ta
mačibo: ma či bo
razi: razi
raziyaw: raziyaw
eⁿdu: eⁿ du
øeča: øeča
soyro: soyro
yogo: yo go
bataxu: bata xu
yiyi: yi yi
yow: yow
øuqˤulo: øuqˤulo
iksewloqol: ikse w lo qo l
hibo: hi bo
lusi: lusi
kaɣataʎal: ka ɣataʎa l
bercinay: be r cinay
diʎozi: diʎozi
bezzoʎozin: be zzoʎozin
bercinab: be r cina b
heⁿše: heⁿ še
bezi: be zi
ɨstɨlo: ɨs tɨlo
eze: eze
haʎɨn: haʎɨn
zɨzel: z ɨ ze l
tut: tut
gamušaza: gamuša za
ezezi: eze zi
øeče: øeče
obutqol: obu tqol
mokoʎo: mo koʎo
qˤʷana: qˤ ʷa na
talas: ta las
mina: m ina
biyo: bi yo
homone: ho mone
xalqi: xa l qi
buʎun: bu ʎun
homonel: ho mone l
lacan: laca n
gulo: gulo
yuxšeda: yuxše da
koka: koka
yaⁿɣun: yaⁿɣun
azbarla: a z bar la
madaʎ: ma daʎ
buxun: bu xun
ʎoloz: ʎolo z
ʎiholi: ʎiholi
omˤoqˤeɣoli: o mˤ o qˤe ɣoli
omˤoqˤe: o mˤ o qˤe
ʎoloɣul: ʎolo ɣul
bahše: ba h še
ˤōⁿˤōʎun: ˤō ⁿ ˤō ʎun
duridaʎa: duri daʎa
ħonoč: ħono č
meʎun: me ʎun
eⁿduɣul: eⁿ du ɣul
ɣinen: ɣinen
mallarasan: mal larasa n
lolbo: lo l bo
lekekše: le ke kše
eⁿdul: eⁿ dul
gulaʎa: gulaʎa
dibiržiko: di bi r žiko
madaʎal: ma daʎa l
dubul: dubul
ɣolʎo: ɣo l ʎo
madaha: ma da ha
busa: busa
meʎɨn: me ʎɨn
miqeɣulin: m i qe ɣulin
buxšezuqun: buxše zuqun
busun: busun
iłel: iłel
aʎ: aʎ
ʎilʲo: ʎilʲo
meʎše: meʎše
huⁿneho: huⁿne ho
ʎilʲol: ʎilʲo l
ħiiʎun: ħi iʎun
onoɣul: ono ɣul
duridin: duri din
ideul: ide ul
bakbaʎa: ba k baʎa
onol: ono l
qarpuz: qarpuz
žohol: žohol
mołmołłu: mo ł mo ł łu
liyin: liyin
zōbɣul: z ō b ɣul
ʎuxxozul: ʎu x xo zul
saxłi: sa x łi
iʎoʎo: iʎoʎo
žoqužaɣul: žo quža ɣul
kereki: ke re ki
atɣužaul: at ɣuža ul
øuʎo: øu ʎo
atɣužal: at ɣuža l
øešti: øe š ti
bexanɨn: be xan ɨn
žohoqˤemul: žohoqˤemul
mequn: me qun
iłeqol: iłe qo l
lakun: la kun
žohoqˤemɨl: žoho qˤem ɨl
lʲuʎʎu: lʲu ʎʎu
zzu: zzu
bečaʎa: bečaʎa
žequl: ž e qul
øeči: øeči
bitte: bi t te
isi: isi
bittenuqul: bittenuqul
yoⁿko: yoⁿko
bittel: bi t te l
øeⁿxeyo: øeⁿ xe yo
bišin: bi š in
qudul: qu dul
alaxʎal: a la x ʎa l
heⁿhemolo: heⁿhemo lo
yaxxač: ya xxač
raxxač: ra xxač
ło: ło
neqi: neqi
boʎoʎo: boʎoʎo
usturʎo: us tur ʎo
øaxxač: øa xxač
øequn: øe qun
øixxidin: øi x xi din
isuqol: isuqo l
aluka: a luka
žahaʎan: ža haʎa n
zamana: zamana
meʎaʎa: meʎaʎa
øeštun: øe š tun
beɣʷa: be ɣʷa
iʎaʎa: iʎaʎa
kukkołsi: kuk ko ł si
øikin: øi kin
oyne: oy ne
awdel: awde l
guca: guca
hobo: hobo
xanqal: xan qa l
laca: laca
ardezi: arde zi
lezi: lezi
awe: awe
awsuɣo: aw su ɣo
øałaqu: øa łaqu
are: are
homonduč: ho mondu č
šiʎu: š iʎu
aye: aye
yakše: ya kše
ownel: owne l
øoⁿko: øoⁿ ko
owne: owne
ʎiho: ʎiho
hosunu: hosunu
usun: usun
oye: oye
owe: owe
tiʎdow: tiʎ dow
boʎo: boʎo
badan: ba dan
butun: bu tun
muxan: mu xan
łuqun: łuqun
guli: guli
žide: žide
loʎol: loʎol
liyi: liyi
tirin: tirin
libi: li bi
ilʲlʲo: ilʲ lʲo
išetɨs: iše tɨs
ondu: ondu
lečbi: leč bi
hobondu: ho bon du
quti: qu ti
kandaza: ka n da za
øuqˤulolin: øuqˤulolin
øoʎoʎololin: øoʎoʎololin
mesedis: mese dis
sahi: sa hi
žikbe: ži k be
miqeso: m i qe so
baydan: bay dan
meži: me ži
øoʎoʎosoho: øoʎoʎoso ho
yoʎoʎoso: yoʎoʎoso
qarʎač: qar ʎa č
øahun: øa hun
codoraw: codoraw
aⁿcmala: aⁿ c mala
žoquža: žo quža
cucan: cucan
cucun: cu cun
ɣoboʎo: ɣo boʎo
uraba: uraba
getlo: ge t lo
øukun: øukun
øečaʎa: øečaʎa
mus: mus
beklun: be k lun
liʎa: liʎa
łayʎol: łay ʎol
øusun: øusun
ɣinala: ɣinala
žoho: žoho
omˤoqˤelo: o mˤ o qˤe lo
øoⁿccuso: øoⁿ c cuso
ħažiyawla: ħ a ži yaw la
žohžoho: žo h žoho
hoⁿqosa: hoⁿ qosa
ħadurłokun: ħ a dur ło kun
lɨdolo: lɨ dolo
aqla: aq la
oge: o ge
ɣonur: ɣonur
mašinaɣa: ma š ina ɣa
taraxtur: tara x tur
baha: baha
bečxi: beč xi
yuʎun: yu ʎun
aqqa: aq qa
solo: so lo
izo: i zo
øuxše: øu xše
dubuł: dubu ł
dandil: dan dil
haca: haca
pɨʎše: p ɨ ʎše
ħaltiʎoz: ħal tiʎo z
yuxšezuqun: yuxše zuqun
kitis: ki tis
huⁿho: huⁿ ho
yuxše: yuxše
qˤʷanač: qˤ ʷa na č
buʎulo: bu ʎulo
loʎoʎo: loʎoʎo
kerti: ke r ti
izzulo: i zzulo
ɣayzala: ɣay za la
lʲoʎoʎo: lʲoʎoʎo
kanaw: ka naw
aqma: aq ma
lʲoʎonuqa: lʲoʎonuqa
ustur: us tur
qbatama: q batama
yoʎonuqa: yoʎonuqa
yaha: ya ha
dubʎo: dub ʎo
sabałɨn: sa ba ł ɨn
diqol: diqo l
bixxidi: bixxidi
dandiłin: dan di łin
qutiʎo: qu tiʎo
roqihol: ro qiho l
qˤʷineč: qˤʷineč
žulik: žuli k
bigo: bi go
nišohon: ni šo hon
ɣolʎon: ɣo l ʎon
dimmoʎo: di m moʎo
čeyiddu: če yi d du
ziko: ziko
xanɨs: xan ɨs
žide35: žide 3 5
hadami: hadam i
buqˤu: buqˤu
xabar: xa bar
biyin: biyin
izze: izze
žikoza: žiko za
ɣelʲin: ɣe lʲ in
koten: ko ten
boqqun: bo qqun
hadaquł: hadaqu ł
žikoloho: žikolo ho
kokše: kokše
kandazas: ka n da zas
wallah: wa l la h
užáč: užá č
hicbič: hi c bi č
øuxxu: øu xxu
užałsi: uža ł si
ilʲban: ilʲ ban
etun: e tun
inu: inu
yotqun: yo t qun
zamanaʎa: zamanaʎa
xol: xo l
ɣoboho: ɣo bo ho
orenu: orenu
neqo: neqo
owenu: owenu
aħmad: a ħ ma d
łul: łul
bakbič: ba k bi č
dudu: dudu
liqše: liqše
dow: dow
duduk: duduk
orduardu: or du ar du
azar: a zar
isixše: isi xše
itoqek: i to qe k
øuhalu: øu ha lu
izzu: i zzu
nal: nal
øoⁿkdogu: øoⁿ kdo gu
žikok: žiko k
dubqo: dub qo
šomo: šo mo
doccu: do c cu
yuqˤuloqo: yuqˤulo qo
doco: do co
himonqe: himon qe
nequn: nequn
docoč: docoč
logłar: lo g łar
liya: li ya
lukše: lukše
øuʎše: øu ʎše
øečłon: øeč łon
isuɣol: isu ɣo l
ide: ide
ʎoloso: ʎoloso
hiblʲa: hi b lʲa
bekxʷi: be k xʷi
łeneʎeru: łene ʎe ru
xanqali: xan qali
hosun: hosun
dogu: do gu
ħono: ħono
bakxʷa: ba k xʷa
qočče: qoč če
łuʎa: łu ʎa
aⁿcmaqa: aⁿ c maqa
tuk: tuk
bekše: be kše
hiboʎa: hiboʎa
hadam: hadam
beterhanič: be te r hani č
øakbič: øak bi č
šomoʎa: šo moʎa
zebu: zebu
edub: edub
burku: bur ku
kulše: kul še
koʎoʎše: koʎoʎše
hadɣal: had ɣal
tɨʎi: tɨ ʎi
lɨʎe: lɨ ʎe
loqun: lo qun
hadamqal: hadam qa l
boʎdiddu: boʎ di d du
iʎa: iʎa
oli: oli
bitixxu: bi ti xxu
biqqa: bi q qa
qdočče: q do č če
ustulʎozi: us tul ʎozi
boʎiddu: boʎi d du
loqo: lo qo
ustuqo: us tuqo
šuka: šuka
bhq: bh q
lečłon: leč łon
łun: łun
calidbi: ca li d bi
nan: na n
busunay: busunay
hoččun: ho č čun
botuqbi: bo tuqbi
iʎbi: iʎ bi
ʎaʎaqu: ʎaʎaqu
tiri: tiri
lacas: lacas
lečunayʎo: lečunay ʎo
ħalla: ħal la
rełaʎa: rełaʎa
židuł: židuł
lequnay: lequnay
iseise: ise ise
xʷaʎi: xʷaʎi
armic: armic
armiczal: armic za l
manarkaba: manar kaba
liyo: li yo
hibalanɨl: hi balan ɨl
hosta: hos ta
ɣolʎoli: ɣo l ʎoli
žibžib: žibžib
qˤʷeneta: qˤ ʷene ta
gid: gi d
yaⁿqi: yaⁿ qi
cdodun: c do dun
papruzbo: pa p ruz bo
golluči: gol lu či
ɣʷaša: ɣʷa ša
šaytdan: šay tdan
golluč: gol lu č
botqi: bo t qi
gollurahal: gol lura ha l
leqʷi: leqʷi
hobołeʎeru: hobo łe ʎe ru
ligu: li gu
lidow: li dow
keranubo: ke ra nu bo
hosunun: hosunun
uⁿč: uⁿ č
žido: ži do
nucumos: nu cu mos
becdcdu: bec d c du
čelʲqo: če lʲ qo
bešon: bešon
xozyaystva: xo z yay s t v a
ɣuruš: ɣuruš
yoqi: yo qi
ħonon: ħonon
beqanan: be qana n
oⁿcon: oⁿ con
qˤʷene: qˤ ʷene
uⁿqe: uⁿ qe
łɨno: ł ɨno
eⁿł: eⁿł
oʎ: oʎ
baʎ: baʎ
oⁿče: oⁿ če
quno: quno
qˤʷenequn: qˤ ʷenequn
bešonun: bešonun
azarin: a zarin
ocon: o con
ištʷaca: ištʷa ca
hosiʎʎu: hosiʎʎu
qˤʷeneiʎʎu: qˤ ʷene iʎʎu
ħonoiʎʎu: ħono iʎʎu
uⁿqeiʎʎu: uⁿ qe iʎʎu
ištʷacaiʎʎu: ištʷa ca iʎʎu
inłacaiʎʎu: in ła ca iʎʎu
haʎʷacaiʎʎu: haʎ ʷa ca iʎʎu
biʎacaiʎʎu: biʎa ca iʎʎu
bešoniʎʎu: bešoniʎʎu
łɨnoiʎʎu: ł ɨno iʎʎu
azarun: a zarun
baʎiʎʎu: baʎiʎʎu
milioniʎʎu: m ili oniʎʎu
židu: židu
baššehol: bašše ho l
øusunay: øusunay
ħonoiʎʎol: ħono iʎʎo l
yusun: yusun
atɣulso: atɣul so
neʎʎu: ne ʎʎu
kečiqan: keči qan
žibžibi: žibžibi
bacun: ba cun
bitin: bi tin
qˤʷanič: qˤ ʷa ni č
qˤʷenqˤʷeneta: qˤ ʷen qˤ ʷene ta
uqeta: uqe ta
hoⁿqoso: hoⁿqoso
maskuʎol: mas ku ʎol
coxun: coxun
yoⁿkše: yoⁿkše
čay: čay
xuʎše: xu ʎše
obutul: obu tul
qˤʷeneiʎʎo: qˤ ʷene iʎʎo
kanduqo: kanduqo
xuweʎ: xu we ʎ
žahaʎasʎa: ža haʎas ʎa
beza: be za
biyeq: bi yeq
homonezi: ho mone zi
yeⁿʎan: yeⁿ ʎa n
yhʎ: y hʎ
kuca: ku ca
xbasar: x basar
yiyey: yiye y
ɣoden: ɣo den
boteqda: bo te q da
bodoše: bo do še
ečoqše: eč o qše
aʎas: aʎas
ɣˤbʷbo: ɣˤ b ʷ bo
koʎše: koʎše
lhēč: l hēč
zikos: zikos
botqaʎa: bo tqaʎa
qalá: qalá
ɣˤe: ɣˤ e
yhēč: y hēč
iʎi: iʎi
lʲuqˤuta: lʲuqˤuta
quraan: quraan
cališše: cališše
øhēč: ø hēč
maxsaraba: ma x sara ba
liše: liše
kulo: kulo
aqban: aq ban
paraqatʎan: paraqat ʎa n
bečče: beč če
užal: uža l
tuqše: tuqše
izzo: i zzo
išu: išu
yotuqšehol: yo tuqše ho l
išanun: i ša nun
pilandiyaʎa: pila n di yaʎa
bexše: be xše
bakkuqarʎa: ba k kuqar ʎa
dagawurɨn: da gaw ur ɨn
beččuqarʎa: beč čuqar ʎa
tɨʎin: tɨ ʎin
kumak: ku ma k
armis: armis
murad: mura d
tubaydin: tu bay din
išun: išun
žohoqˤemil: žoho qˤem il
kaɣat: ka ɣat
qʷayinda: qʷayin da
bhēč: bhēč
zaynabi: zay na bi
žʷarʎadaya: ž ʷar ʎa daya
øeqbaʎa: øe q baʎa
ilʲe: ilʲ e
øeɣʷa: øe ɣʷa
ʎaʎaqú: ʎaʎaq ú
allahisuqo: a l la hisuqo
isxo: is xo
žužaħiłil: žuža ħi łil
kula: kula
nazirho: na zi r ho
yeɣʷa: ye ɣʷa
iʎʎuło: iʎʎu ło
ʎunʎoz: ʎun ʎo z
muħamadi: mu ħ amadi
øečło: øeč ło
aslanbeg: as la n be g
žilʲlʲoɣul: žilʲ lʲo ɣul
øuxa: øu xa
ɣode: ɣo de
is: is
øotuqdow: øo tuq dow
yokdow: yo kdow
hˤamˤaˤe: h ˤ amˤ a ˤ e
kaɣatɨn: ka ɣatɨn
boqun: boqun
žoholi: žoholi
yuwoxdow: yu wo x dow
yečɨn: yeč ɨn
titdow: ti tdow
issuło: is su ło
us: us
yuxalaha: yu xa la ha
maršrutka: mar š ru t ka
ħalti: ħal ti
biyalaha: bi ya la ha
kišeʎo: kiše ʎo
øahalaha: øahala ha
boqalaha: bo qa la ha
bezalaha: be za la ha
muⁿło: muⁿ ło
xinkebo: xin ke bo
liyalaha: li ya la ha
ʎar: ʎar
øotuqło: øo tuq ło
kici: ki ci
iyes: iye s
ilʲuli: ilʲuli
čamassekun: čamasse kun
himonun: himonun
guwel: gu we l
soyrozali: soyro za li
ʎibaʎa: ʎibaʎa
yotuqšeqa: yo tuqše qa
codšeč: cod šeč
codše: cod še
lečbič: lečbič
cicibo: ci ci bo
quqšeč: quqšeč
quqše: quqše
iyeʎ: iye ʎ
ilʲuqol: ilʲuqo l
mižó: mižó
hilʲlʲak: hilʲ lʲa k
buxate: bu xate
kandaba: ka n da ba
ilʲo: ilʲo
buxše: buxše
aminatis: aminatis
kokač: kokač
kokate: kokate
beče: beče
iłelin: iłelin
bičidbi: bi či d bi
ložeč: lo ž eč
leunay: le unay
ununay: ununay
mokoyey: mo koye y
ačqaygy: a č qay g y
łon: łon
indu: in du
qˤubay: qˤu bay
ygcbi: y g c bi
botuqbič: bo tuqbi č
ɣodo: ɣo do
ʎusbič: ʎus bi č
mhʎ: m hʎ
bečbi: beč bi
žilʲlʲo: žilʲ lʲo
saqiriyazaʎali: saqi ri ya zaʎa li
ɣinaza: ɣina za
ʎibaha: ʎibaha
xgn: x g n
bečunay: bečunay
ɣˤbʷyi: ɣˤ b ʷ yi
lacun: lacun
lusbi: lus bi
lacbič: lac bi č
huniža: huni ža
kereyun: ke re yun
kerebič: ke re bi č
eⁿxuł: eⁿ xu ł
yečunay: yečunay
usanbič: usa n bi č
calidin: calidin
calidbič: ca li d bi č
hici: hi ci
čido: či do
mokonu: mo konu
luʎxa: lu ʎ xa
iⁿyanun: iⁿ ya nun
tuqun: tuqun
goqqu: go qqu
kandin: ka n din
łuqon: łuqon
isinay: isinay
ɣonoł: ɣono ł
hicin: hi cin
yečču: yeč ču
ʎussuqarʎa: ʎus suqar ʎa
yaškan: ya š ka n
yoqun: yoqun
yaⁿɣˤun: yaⁿ ɣˤ un
ilʲohol: ilʲo ho l
kereše: ke re še
yeⁿgi: yeⁿ gi
eⁿxeɣol: eⁿ xe ɣo l
øokšeso: øokše so
øiqin: øi qin
codorawil: codoraw il
baca: ba ca
mokšeso: mo kše so
ħežʎoɣul: ħ e ž ʎo ɣul
gobiso: go biso
qudun: qu dun
kepaw: ke paw
øuhi: øu hi
mokše: mo kše
uškul: uš kul
miqe: m i qe
hoddow: ho d dow
žikon: žikon
eⁿšin: eⁿ š in
yaraɣi: yaraɣi
gobič: gobi č
ʎuxun: ʎu xun
ʎʷahidow: ʎ ʷa hi dow
himonuč: himonu č
ihoʎdowil: ihoʎ dow il
soyrobo: soyro bo
kokxa: kok xa
šuʎi: šu ʎi
iton: iton
bazar: ba zar
bečdow: beč dow
goqatew: goqate w
gugun: gu gun
isuɣoɣul: isu ɣo ɣul
inhod: in ho d
keči: keči
bažari: ba žari
heresi: he re si
cikiddu: ci ki d du
isa: isa
łuqoqh: łuqo q h
bhqʷ: bh qʷ
iłeqo: iłe qo
nišoho: ni šo ho
yeⁿʎa: yeⁿ ʎa
ēⁿxʷi: ēⁿ xʷi
qalal: qa la l
tort: tor t
yaca: ya ca
behidey: be hide y
muslimi: mus li m i
bertinoʎol: be r tinoʎol
buxa: bu xa
arxeologzaqa: ar xe o lo g zaqa
boqa: bo qa
xazina: xa zina
gullu: gul lu
hˤamˤaˤeɣol: h ˤ amˤ a ˤ e ɣo l
xʷasar: xʷasar
yiyinso: yi yin so
kducá: kdu c á
iyоʎ: i yо ʎ
kanduqol: kanduqo l
hoddu: ho d du
ʎolʎo: ʎolʎo
meʎa: me ʎa
bukše: bukše
xitilbegqol: xi til be g qo l
yoⁿkda: yoⁿ kda
yukku: yuk ku
ɣonołɣužaz: ɣono ł ɣuža z
øoⁿkšeso: øoⁿ kše so
iduidu: idu idu
hadaɣa: hada ɣa
exnuʎ: e x nu ʎ
reła: reła
leɣʷa: le ɣʷa
øukše: øukše
xwadakarɨs: x wada kar ɨs
oynu: oy nu
yaccu: yaccu
lokolun: lo ko lun
ɣuɣu: ɣu ɣu
yahi: ya hi
yahun: ya hun
øahi: øahi
uqe: uqe
yeⁿʎaʎa: yeⁿ ʎaʎa
čidoʎoli: či doʎoli
idezi: ide zi
vedenayazi: v e denaya zi
øeⁿʎʎu: øeⁿ ʎʎu
rayoncentriʎo: rayon cen t riʎo
øusi: øusi
ʎultan: ʎul ta n
milicis: m ili cis
forman: f or man
šiʎun: š iʎun
qʷˤenequn: qʷ ˤ enequn
łunoiʎʎu: łuno iʎʎu
istalin: is ta lin
øižžoqarʎa: øiž žo qar ʎa
maštaban: ma š ta ban
nuqun: nuqun
lečaʎa: lečaʎa
istalini: is ta lini
mižuli: mižuli
qočču: qoč ču
ilʲoilʲon: ilʲo ilʲon
ažnazan: a ž na za n
qˤʷine: qˤ ʷine
axirgi: a xi r gi
xrušowi: x rušow i
židun: židun
bešti: be š ti
čačanzan: čačanzan
xadi: xadi
yixišše: yi xiš še
dilʲi: dilʲ i
lʲuʎexbo: lʲu ʎe x bo
lʲuʎxi: lʲuʎxi
račibon: ra či bon
noci: no ci
nocceč: no c ceč
yiki: yiki
yečunʎo: yečun ʎo
yečunayʎo: yečunay ʎo
awse: aw se
ħalli: ħal li
ħukmu: ħ uk mu
žequł: žequł
baqˤbič: baqˤ bi č
beča: beča
yokun: yo kun
qʷariłin: qʷari łin
haqu: haqu
loko: lo ko
bitural: bitural
isbič: is bi č
užaqal: užaqal
iʎbik: iʎ bi k
dubqol: dub qo l
øuwexbo: øu we x bo
šukunay: šukunay
isaʎa: isaʎa
dubon: dubon
diyon: di yon
žequłso: žequł so
łɨqi: ł ɨ qi
tokay: to kay
yotqan: yo t qan
yotqunay: yo t qunay
mokoʎozi: mo koʎozi
urɣiššeč: urɣi š šeč
øuhun: øu hun
øečunayko: øečunay ko
ɨsnaba: ɨs na ba
mokoʎol: mo koʎol
øaha: øaha
lukku: luk ku
cоxda: c оx da
xasayurtil: xasayur til
onolin: onolin
gucaʎa: gucaʎa
busi: busi
boqoʎun: bo qoʎun
coxu: coxu
minutaba: m inu ta ba
botuqšehol: bo tuqše ho l
øahaʎa: øahaʎa
gucšehol: gu c še ho l
kakba: ka k ba
biyacew: bi ya ce w
lɨsɨn: lɨs ɨn
lequn: lequn
muħamadɨl: mu ħ ama d ɨl
øokun: øo kun
balnicʎozi: ba l ni c ʎozi
mížo: mížo
gollubahab: gol lu baha b
buwes: buwes
liłin: li łin
pikruʎo: pi k ru ʎo
bodoxkun: bo do x kun
mołłu: mo ł łu
bidow: bi dow
biyaʎa: bi yaʎa
lokoda: lo ko da
išetis: iše tis
gurħidin: gur ħi din
luwes: lu we s
qʷainda: qʷa in da
ʎusunda: ʎusun da
yuwоs: yu w о s
šaharʎaul: ša har ʎa ul
øoⁿkdowda: øoⁿkdow da
øuwes: øuwes
yoⁿkdowda: yoⁿ kdow da
ħaltiʎol: ħal tiʎol
yuxdowda: yu x dow da
yuwes: yu we s
øoⁿkdow: øoⁿkdow
øuwesbida: øuwes bi da
øečunʎo: øečun ʎo
øečunayʎo: øečunay ʎo
mičahaw: m i ča haw
atɣuli: atɣuli
huⁿnema: huⁿnema
busiʎo: busiʎo
qˤemɨn: qˤem ɨn
leʎɨn: leʎɨn
žikó: ži k ó
ħonolux: ħono lu x
ˤоⁿˤоʎaʎa: ˤ оⁿ ˤ о ʎaʎa
øuha: øu ha
čgl: čgl
mašina: ma š ina
bertinqe: be r tin qe
yeče: yeče
sebahay: se bahay
yečbiko: yeč bi ko
bertinoʎo: be r tinoʎo
ɣebilʲa: ɣe bilʲa
beccu: bec cu
beɣʷi: be ɣʷi
hobonduta: ho bon du ta
ɣinaban: ɣina ban
xunda: xun da
hobožesʎa: hobo žes ʎa
yotqunʎo: yo t qun ʎo
roqiqe: ro qi qe
he: he
roqun: ro qun
beqlo: be q lo
bakzahasa: ba k za hasa
øokše: øokše
muħamá: mu ħ am á
ašemʎo: ašemʎo
ʎari: ʎari
iłeiłelo: iłe iłelo
ɣinaqal: ɣinaqa l
hico: hico
miže: miže
kukun: kukun
žun: žun
ɣelʲaya: ɣe lʲaya
guto: gu to
ak: a k
usana: usa na
calido: ca li do
ʎiš: ʎi š
aⁿc: aⁿ c
xešle: xe š le
nuye: nu ye
nuyo: nu yo
goqo: go qo
qbečo: q beč o
qʷeče: qʷeče
qočo: qoč o
qoče: qoče
kilika: kili ka
lusxo: lus xo
lakxʷa: la k xʷa
tuwоʎbo: tu w о ʎ bo
øēⁿqbo: øēⁿ q bo
idel: ide l
buwоʎbo: bu w о ʎ bo
ʎurowоdbo: ʎuro w о d bo
øоⁿkbo: ø оⁿ k bo
bašše: bašše
xanše: xan še
goʎo: goʎo
patimat: pati mat
goʎoʎo: goʎoʎo
yezoʎo: ye zoʎo
ine: ine
batałi: bata łi
yuhoʎo: yu hoʎo
isse: isse
busło: busło
patimati: pati mati
muħamadul: mu ħ ama dul
behidоy: be hi dоy
øoⁿkoʎo: øoⁿ koʎo
yesse: ye sse
urɣelʲ: ur ɣe lʲ
ritiłoʎo: ri ti łoʎo
elʲ: e lʲ
qabulay: qa bulay
yusoʎo: yusoʎo
ruħ: ru ħ
imanʎa: i man ʎa
busoʎo: busoʎo
quqa: quqa
šešoʎo: še šoʎo
barkat: bar kat
liyoʎo: liyoʎo
žužahmal: žuža h mal
bekloʎo: be k loʎo
kampot: kam po t
xuwоʎboʎo: xu wоʎboʎo
mičahałše: m i ča ha ł še
golło: gol ło
bečło: beč ło
øotuqše: øo tuqše
øuxleʎo: øu x leʎo
amru: am ru
biyi: bi yi
iseisulo: ise isulo
soldatzaqa: so l dat zaqa
wasiyat: wasi yat
hicoʎo: hicoʎo
boɣo: bo ɣo
ayšat: ay šat
kandiyu: ka n di yu
zoxukdow: zo xukdow
øēⁿgbo: øēⁿ g bo
wole: wo le
qududa: qu du da
øēⁿg: øēⁿ g
koc: koc
boboluda: bobolu da
lokоxbo: lo k оx bo
bobolu: bobolu
lokоx: lo k оx
yeⁿqo: yeⁿ qo
leʎbiło: leʎ biło
unexbo: une x bo
ɣˤʷe: ɣˤ ʷe
haⁿnbiło: haⁿ n biło
lokoʎočun: lo koʎo čun
onoidel: ono ide l
ukbiło: uk biło
nalič: nalič
nalkqe: nal k qe
botokalu: bo to ka lu
urɣiše: urɣiše
dibirɣoli: di bi r ɣoli
yeⁿʎun: yeⁿ ʎun
hibočibok: hi bo či bo k
madahal: madahal
øeqʷate: øe qʷate
kadso: ka d so
omˤoqdˤen: o mˤ o q dˤ en
hosso: hosso
øoⁿkdun: øoⁿ kdun
hadaɣaɣul: hada ɣa ɣul
øuqˤuso: øuqˤuso
mogon: mo gon
ħaltiše: ħal tiše
dayarkałun: dayar ka łun
øogułun: øo gu łun
qʷiše: qʷiše
hˤamˤaɣˤe: h ˤ amˤ a ɣˤ e
kutaxe: ku ta xe
qirisaxe: qi risa xe
xˤeʎmare: xˤ e ʎ mare
asʎasa: as ʎasa
kˤabdaxi: kˤab da xi
onoz: ono z
abumuslim: a bu mus li m
šayx: šayx
øotuqquqarʎa: øo tuqquqar ʎa
razoblačitʲ: ra zo b la či t ʲ
ličtotun: lič to tun
ʎuxxo: ʎu x xo
dabaɣas: da ba ɣas
himonaba: himona ba
madaʎɣul: ma daʎ ɣul
lʲuʎxun: lʲu ʎ xun
liyan: liyan
liqbič: liqbi č
øeqʷi: øe qʷi
gucuca: gu cu ca
łuno: łuno
heⁿšebo: heⁿ še bo
gɨd: gɨd
mižo: m i žo
bezzu: be zzu
iyanun: i ya nun
qabulab: qa bula b
sadaqa: sa daqa
beqloʎo: be q loʎo
qˤʷineiʎʎo: qˤ ʷine iʎʎo
gamuš: gamuš
kilometra: kilo me t ra
buxˤala: bu xˤ a la
istakan: is ta ka n
uⁿqˤe: uⁿ qˤe
yezi: ye zi
yusło: yus ło
abedu: a be du
biki: biki
tegelas: te ge las
balan: balan
ezalaban: e za la ban
ɣonoʎol: ɣonoʎol
eⁿšmolo: eⁿ š mo lo
ⁿxristanzas: ⁿ x ris ta n zas
beččuɣ: beč ču ɣ
qonnobo: qon no bo
leččuɣ: leč ču ɣ
ⁿudulaba: ⁿ u dulaba
ⁿøokkuɣ: ⁿ øo k ku ɣ
ⁿøotuqqu: ⁿ øo tuqqu
awtun: aw tun
ⁿezol: ⁿ e zo l
gobisoɣ: go biso ɣ
øekʷlun: øekʷlun
qˤbene: qˤ bene
kuče: ku če
biskinaw: bis kinaw
gˤolʲlʲuč: gˤolʲ lʲu č
aqˤba: aqˤ ba
luxun: lu xun
isuʎol: isu ʎol
docon: do con
aʎazas: aʎa zas
dibirbo: dibirbo
bercinal: be r cinal
tarpa: tar pa
wacahawus: wa ca haw us
tuqo: tuqo
osenniy: osen ni y
lezo: le zo
uʎumho: u ʎu m ho
bertin: be r tin
quqlezas: quq le zas
exenun: e xenun
łuqqun: łuqqun
aqʷˤi: aqʷ ˤ i
lacɨn: lac ɨn
musa: musa
aħmadʎazi: a ħ ma d ʎa zi
dubʎozi: dub ʎozi
yezo: ye zo
pisukčakarʎazin: pisuk ča kar ʎa zin
patimatiʎozin: pati matiʎozin
øog: øo g
duridey: duride y
kandiʎozi: ka n diʎozi
toxaw: to xaw
ɣinaʎazin: ɣinaʎa zin
biže: bi ž e
biyоy: bi yо y
biguʎozin: bi gu ʎozin
dubulʎozin: dubul ʎozin
iʎʎuʎozi: iʎʎu ʎozi
rexnezʎozin: re x ne z ʎozin
liže: liže
ešenoz: e šeno z
tarpaʎazi: tar paʎa zi
lʲuqˤu: lʲuqˤu
dubloʎozi: dub loʎozi
kanduqolʎozi: kanduqo l ʎozi
bešuttuʎozi: be šu t tu ʎozi
mesediʎozin: mese diʎozin
tuʎi: tu ʎi
dubʎozin: dub ʎozin
isuʎozin: isu ʎozin
øiže: øiž e
øaccu: øa c cu
siħirab: si ħi ra b
gˤolʲlʲočʎozin: gˤolʲ lʲo č ʎozin
klasma: k las ma
batuli: batuli
gˤolʲlʲočułsi: gˤolʲ lʲo ču ł si
atamahacew: atama ha ce w
uʎumoho: u ʎu mo ho
bhqbi: bh qbi
išucew: išu ce w
aqiʎ: aqiʎ
oⁿco: oⁿ co
dolarcew: dolar ce w
isxi: isxi
qunocew: quno ce w
ilʲoɣul: ilʲo ɣul
dadá: dad á
hoⁿko: hoⁿ ko
mēžbi: m ē ž bi
babá: ba b á
kartuška: kar tuš ka
neždowcew: než dow ce w
øołu: øo łu
øuʎʎu: øu ʎʎu
istɨlo: is tɨlo
kurtkaɣa: kur t ka ɣa
yałaqu: ya łaqu
kurtka: kur t ka
ɨstɨs: ɨs tɨs
zihezałsi: zihe za ł si
ʎuʎi: ʎu ʎi
ilʲułsi: ilʲu ł si
hadi: hadi
dacba: da c ba
łulla: łul la
kandułsi: kandu ł si
xolho: xo l ho
xinkezala: xin ke za la
bušnebo: buš ne bo
bataxulo: bata xulo
kampitaba: kam pi ta ba
klasuč: k lasu č
becica: beci ca
bukku: buk ku
učiteli: u či te li
yecici: ye ci ci
lʲuxˤdowlo: lʲu xˤ dow lo
łeyi: łe yi
karimlo: kari m lo
karimʎoso: kari m ʎoso
žurnal: žur nal
lukzaha: luk za ha
iho: iho
goqše: go qše
ayšati: ay šati
beqes: be qe s
tošu: to šu
iqˤqˤo: i qˤ qˤ o
dah: da h
hasanɣal: hasa n ɣal
užas: užas
muħamadɨs: mu ħ ama d ɨs
saɣaw: sa ɣaw
haybataw: hay bataw
haybatabta: hay bata b ta
øuʎʎun: øu ʎʎun
bercinawin: be r cinaw in
saɣawin: sa ɣaw in
øogun: øo gun
žuka: žuka
heʎun: he ʎun
yečdow: yeč dow
luccu: luccu
atamaha: atama ha
luxxu: lu xxu
leča: leča
šamilin: šam ilin
ihoho: iho ho
soyrozolo: soyro zo lo
оⁿču: оⁿ ču
isuqo: isuqo
boko: bo ko
øakʷaʎa: øak ʷaʎa
diɣolun: diɣolun
koki: koki
madinati: madinati
talaqasa: ta laqasa
goqun: go qun
užazal: uža za l
kʷeše: k ʷe še
beterhanɨl: be te r han ɨl
kiti: ki ti
huⁿza: huⁿ za
huⁿhbo: huⁿ h bo
ɣanqidokun: ɣa n qi do kun
wa: wa
iłeʎozi: iłe ʎozi
beqbi: be qbi
reštidin: re š ti din
tuqunay: tuqunay
tuqi: tuqi
lołun: lo łun
łiki: łiki
łikli: łik li
kokli: kok li
buxadi: bu xadi
buxadli: bu xa d li
ɣinaqa: ɣinaqa
qaba: qaba
luci: lu ci
qebedqo: qe be d qo
tir: tir
bodolli: bo dol li
yacli: ya c li
dac: da c
iʎdow: iʎ dow
ɣinaɣal: ɣina ɣal
cališe: ca liše
tamsa: tam sa
bacałakše: ba ca ła kše
užaza: uža za
šobolu: šo bo lu
yuʎuxše: yu ʎu xše
užaba: užaba
bataxun: bataxun
koron: koron
bečunʎo: bečun ʎo
bečunayʎo: bečunay ʎo
yuqˤučen: yuqˤu čen
uqˤučen: uqˤu čen
kadɨn: ka d ɨn
kandaban: ka n da ban
užaban: užaba n
sanqiriyazaʎa: sa n qi ri ya zaʎa
bhč: bh č
išetin: iše tin
bacałakʷi: ba ca ła k ʷi
ya: ya
huⁿnɣoɣul: huⁿ n ɣo ɣul
øotqa: øo tqa
huⁿn: huⁿ n
muħamadɣal: mu ħ ama d ɣal
botqa: bo tqa
yagi: ya gi
nuɣoki: nu ɣo ki
ucnu: u c nu
lizaha: li za ha
ruslani: rus la ni
kirpič: ki r pič
yeⁿqbi: yeⁿ qbi
ɣuɣun: ɣu ɣun
bibi: bi bi
biqqi: biqqi
amma: am ma
biqixbi: bi qi x bi
baħarayin: ba ħ arayin
baħarawin: baħaraw in
low: lo w
orodun: oro dun
muħaman: mu ħ aman
øuxˤada: øu xˤ a da
lolo: lo lo
baxxač: ba xxač
awedu: awe du
ayedu: aye du
obubon: obu bon
išubon: išu bon
aredu: are du
oⁿgɨn: oⁿ gɨn
učin: u čin
kilikaban: kili ka ban
oⁿgnobon: oⁿ g no bon
zorun: zorun
bocon: bocon
boloʎol: bo loʎol
zoya: zoya
oⁿgin: oⁿ gin
čiken: či ken
ʎilʲbon: ʎilʲ bon
lotqi: lo t qi
zihebon: zihe bon
raxxa: ra x xa
žihebon: ži he bon
izzun: i zzun
omˤoqˤebon: o mˤ o qˤe bon
ʎusun: ʎusun
ačalaha: a ča la ha
botdqdaʎa: bo td q daʎa
yolun: yolun
eⁿso: eⁿso
puʎun: pu ʎun
lešutše: lešu tše
sasdaxše: sas da xše
asaxu: asa xu
dunnal: dun nal
yog: yo g
yečbi: yeč bi
yuci: yu ci
hˤamˤaɣˤeʎo: h ˤ amˤ a ɣˤ e ʎo
buži: buži
diʎo: diʎo
čiqi: či qi
awde: awde
xanłis: xan łis
mičahałis: m i ča ha łis
pikru: pi k ru
ɣoboqol: ɣo bo qo l
gucdcdu: gu c d c du
øuʎate: øu ʎate
mokunay: mo kunay
liʎał: liʎa ł
coxaʎa: co xaʎa
qaʎu: qaʎu
huⁿnʎo: huⁿ n ʎo
izzul: i zzul
muc: mu c
biqdogu: bi q do gu
qalaxu: qa la xu
łeneholk: łene ho l k
yiqin: yi qin
kandɨqo: ka n d ɨ qo
qalaqa: qa laqa
nuqi: nuqi
bada: ba da
yotqaʎa: yo tqaʎa
yaɣˤɨn: ya ɣˤ ɨn
amasi: amasi
puʎše: pu ʎše
din: din
bidowlo: bi dow lo
ʎarmalun: ʎar malun
iseisul: ise isul
ʷʎo: ʷ ʎo
nabiɣol: na bi ɣo l
tiʎʎu: tiʎʎu
asiyatla: asi yat la
qayiše: qayiše
lezzu: le zzu
magnitofon: ma g ni to f on
žen: žen
iʎbič: iʎ bi č
užaɣal: uža ɣal
tɨʎo: tɨ ʎo
widra: w i d ra
iná: in á
pirkaz: pi r ka z
allahise: a l la hise
bocdi: boc di
neqda: neq da
hicce: hi c ce
lečunay: lečunay
nartawɣal: nar taw ɣal
meqšezuqun: me qše zuqun
bazarʎalin: ba zar ʎalin
hadamil: hadam il
zihebo: zihe bo
iłeiłel: iłe iłel
biya: bi ya
iłeiłeluč: iłe iłelu č
øoⁿkaʎa: øoⁿkaʎa
weliseped: we lise ped
lezun: le zun
yuqˤučé: yuqˤu čé
židul: židul
kurkulos: kur kulos
banka: ban ka
øečeøeče: øeče øeče
bertinnos: be r tin nos
lacaco: laca co
gulše: gul še
wo: wo
muħama: mu ħ ama
laga: la ga
eⁿhuz: eⁿ hu z
łiłukaqa: łi łukaqa
mołun: mo łun
kandazaqa: ka n da zaqa
łulun: łulun
yāgɣbo: y ā g ɣ bo
biʎ: biʎ
mˤgɣˤul: mˤ g ɣˤ ul
ħaymanla: ħay man la
aⁿxˤaʎa: aⁿ xˤ aʎa
lexun: le xun
ʎdoloɣul: ʎ dolo ɣul
kdoʎʎu: kdoʎʎu
ʎduqde: ʎ duq de
coʎše: coʎše
buʎdan: bu ʎ dan
buʎdun: bu ʎ dun
nartawba: nar taw ba
qačaɣla: qa ča ɣ la
kakala: ka ka la
šubuł: šu bu ł
tubin: tu bin
coʎun: coʎun
øoqun: øo qun
xundá: xun d á
øeⁿʎan: øeⁿ ʎa n
øeʎun: øe ʎun
oʎʎelo: oʎ ʎe lo
žikolo: žikolo
yotdqdun: yo td q dun
łiłukda: łiłukda
meqdun: me q dun
lekdun: le kdun
bocdlo: boc d lo
aⁿxˤaʎda: aⁿ xˤ aʎ da
buxšeč: buxšeč
behenazi: be henazi
lekdkdu: le kd kdu
tiratiran: tiratira n
lutdxun: lu td xun
haʎun: haʎun
lexexše: le xe xše
liʎaba: liʎa ba
kantaz: ka n ta z
iksegu: ikse gu
ħallaqe: ħal laqe
lacxi: lac xi
arslani: ar s la ni
ɨstɨqoz: ɨs tɨ qo z
usani: usa ni
žužuč: žužu č
urɣišše: urɣi š še
kečiqani: keči qani
urɣidi: urɣi di
yaci: ya ci
loki: lo ki
žikʷe: ži k ʷe
pilʲu: pilʲu
xuxuterbo: xu xu te r bo
bezo: be zo
tušman: tuš man
øuhe: øu he
yaɣˤla: ya ɣˤ la
oh: o h
barkaman: bar kaman
puʎo: pu ʎo
ciyoⁿn: ci yoⁿ n
xexłin: xe x łin
eʎun: e ʎun
muħamadqa: mu ħ ama d qa
židuli: židuli
barkala: bar ka la
ciwuʎše: ci w u ʎše
ciwuʎoxi: ci w u ʎo xi
ʎusi: ʎusi
ʎusxi: ʎus xi
ʎusa: ʎusa
qʷaše: qʷa še
qʷaxki: qʷa xki
utanasa: u ta nasa
ɣamasi: ɣamasi
kandiqo: ka n diqo
utanaso: u ta naso
yezxun: ye z xun
qʷaya: qʷaya
pazral: pa z ral
srazu: s ra zu
liqi: liqi
žulikza: žuli k za
lakše: la kše
surat: surat
bakxʷi: ba k xʷi
utanata: u ta nata
zidorobo: zi doro bo
lakʷa: la k ʷa
leštun: leš tun
lolxi: lo l xi
xiyež: xiye ž
xiži: xi ži
xižki: xi ž ki
lola: lo la
calidoki: ca li doki
urɣidoki: urɣi doki
calidoxki: calidoxki
urɣidoxki: urɣi do xki
toxturi: to x turi
išetqo: iše t qo
daru: daru
codxi: cod xi
madinatqa: madinatqa
išanaxoxki: i ša na xo xki
wacahawqaɣužaz: wa ca haw qa ɣuža z
udul: u dul
nežxi: než xi
nežxoxki: než xo xki
yotokoxki: yo to ko xki
xižkoxki: xi ž ko xki
hˤamˤaɣˤeqo: h ˤ amˤ a ɣˤ e qo
inaqa: inaqa
gaziyat: ga zi yat
ayšatqa: ayšatqa
ciwuʎoxki: ci w u ʎo xki
patimatqa: pati matqa
tuqoxki: tuqo xki
ciwuʎxoxki: ci w u ʎ xo xki
hadamqa: hadam qa
tuqxoxki: tuq xo xki
calidoxoxki: ca li do xo xki
bečču: beč ču
biti: bi ti
ⁿqudul: ⁿ qu dul
biššuɣ: bi š šu ɣ
caliddu: ca li d du
yuʎi: yu ʎi
ʎihoⁿl: ʎihoⁿ l
aka: a ka
ɣuraz: ɣura z
lucxi: lu c xi
lucuxxu: lu cu xxu
ɣur: ɣur
yuqˤu: yuqˤu
maħačqalaʎaɣul: maħač qa laʎa ɣul
meʎi: me ʎi
hosɣoli: hos ɣoli
ʎuxše: ʎu xše
ɣˤbe: ɣˤ be
bikkuso: bi k kuso
ʎuxi: ʎu xi
ruzma: ruz ma
zebʎo: ze b ʎo
yezzu: ye zzu
yuxxu: yu xxu
ɣonołɣul: ɣono ł ɣul
meʎdow: me ʎ dow
aʎala: aʎa la
balaha: ba la ha
zonok: zono k
eⁿcaʎa: eⁿcaʎa
eⁿca: eⁿ ca
qotas: qo tas
leza: le za
xiriyalta: xi riyal ta
uškulun: uškulun
maskuʎo: mas ku ʎo
yoⁿki: yoⁿ ki
yoⁿkku: yoⁿ k ku
maħačkalaʎa: maħač ka laʎa
žikol: žikol
tiʎi: tiʎi
patimatil: pati matil
øiyeq: øi yeq
bešuttu: be šu t tu
qarʎa: qar ʎa
bgh: b g h
lēqʷ: l ē qʷ
łu: łu
calidоy: ca li dоy
hobožidul: hobo židul
liyоq: li yо q
øakun: øakun
ritiłbiso: ri ti ł biso
xasavyurtil: xasa v yur til
yoⁿkšezuqun: yoⁿkše zuqun
ilʲlʲó: ilʲ lʲ ó
šayix: šayi x
buwoxi: bu woxi
dil: dil
xuʎa: xu ʎa
bezan: bezan
øotqan: øo t qan
ɣolo: ɣo lo
neqa: neqa
baydanʎazi: bay dan ʎa zi
ize: i ze
aħmadʎa: a ħ ma d ʎa
tadar: ta dar
ɨsnazal: ɨs na za l
beqʷi: be qʷi
eⁿxʷi: eⁿ xʷi
zorlo: zor lo
mokdoʎdoz: mo kdoʎ do z
mokdo: mo kdo
zorɨs: zor ɨs
ħal: ħal
ēⁿxbi: ēⁿ x bi
bičkdʷa: bi č kd ʷa
ēⁿx: ēⁿ x
ayłe: ay łe
puppyobłinter: pu p p yo b łin te r
playinf: p layin f
kučuł: ku ču ł
keranu: ke ra nu
ɣolʎoso: ɣo l ʎoso
moła: mo ła
xalitho: xa li t ho
raziłi: razi łi
mokan: mo ka n
lido: li do
bitxa: bi t xa
baybikidi: bay biki di
yerži: yer ži
moʎał: moʎa ł
lakʷi: la k ʷi
mičahay: m i ča hay
yeqnu: yeq nu
aniš: a ni š
dubułsi: dubu ł si
øeqnu: øe q nu
bitixnu: bi ti x nu
tuqaʎa: tuqaʎa
yeqʷi: yeqʷi
ʎurali: ʎurali
liyeq: liyeq
lʲuʎʎo: lʲu ʎ ʎo
beznu: be z nu
banima: bani ma
bezdow: bezdow
bezdowłar: bezdow łar
pal: pal
kuli: kuli
yečoqbič: yeč o qbi č
yoⁿknus: yoⁿ k nus
karimi: karimi
ilʲuqo: ilʲuqo
qˤemis: qˤem is
golnus: gol nus
nuałi: nu a łi
karim: kari m
ilʲoho: ilʲo ho
øečnus: øeč nus
išetil: iše til
ho: ho
leɣʷi: le ɣʷi
matu: matu
bucuxbinus: bu cu x binus
yeznus: ye z nus
izuʎol: i zu ʎol
botoki: bo to ki
begawul: be gaw ul
øotuqnus: øo tuq nus
lotoki: lo to ki
o: o
leqnuʎo: leq nu ʎo
rekoqaw: re ko qaw
bahi: ba hi
yolnuʎo: yol nu ʎo
bužbi: buž bi
yeⁿʎnuʎo: yeⁿ ʎ nu ʎo
čuħidin: ču ħi din
beqnuʎo: be q nu ʎo
øečoqa: øeč o qa
ha: ha
ɣiɣˤulbik: ɣi ɣˤ ul bi k
mičahałar: m i ča ha łar
čuħidinin: ču ħi dinin
beqeqše: be qe qše
qbiše: qbiše
yācbi: y ā c bi
bičidi: bi či di
boqše: bo qše
lokoʎol: lo koʎol
luxˤi: lu xˤi
zaynabɨl: zay na bɨl
øotuqqu: øo tuqqu
sudiyá: su di y á
čeydoki: če y doki
musá: mus á
bitixxitixxu: bi ti x xi ti xxu
bitixxułar: bi ti xxu łar
beqše: be qše
zaman: zaman
łuqi: łuqi
łuqqi: łuq qi
tubaydi: tu bay di
øuxdowus: øu x dow us
leʎdowus: leʎ dow us
øižnuʎo: øiž nu ʎo
øukku: øuk ku
lukun: lukun
ičla: ičla
øiqi: øi qi
išetɨl: iše tɨl
yiqše: yi qše
mangal: man ga l
muɣokše: mu ɣo kše
muɣokbič: mu ɣo k bi č
biqše: bi qše
bitxin: bi t xin
kˤaba: kˤaba
botuqqu: bo tuqqu
øiqqu: øi qqu
qˤuqˤlebo: qˤuqˤ le bo
lesše: le s še
lacše: lac še
aⁿqˤʷan: aⁿ qˤ ʷa n
akalun: a ka lun
ɣudułsi: ɣu du ł si
huⁿnen: huⁿnen
beštun: be š tun
zeyi: ze yi
qˤʷeneč: qˤ ʷeneč
bikin: bikin
øuʎxun: øu ʎ xun
ʎuqidin: ʎuqi din
øuhbič: øu h bi č
unšeč: un šeč
eⁿduqa: eⁿ duqa
mokšezuqun: mo kše zuqun
unbič: un bi č
čuli: čuli
ihoʎše: ihoʎše
qeburdašeč: qe bur da šeč
qeburdabič: qe bur da bi č
himonič: himoni č
žohon: žohon
qˤemłin: qˤem łin
žawab: žawa b
bibič: bi bi č
øuʎi: øu ʎi
mokonun: mo konun
ɣiˤulbič: ɣi ˤ ul bi č
øahan: øaha n
aⁿcmaɣaul: aⁿ c ma ɣa ul
øoki: øo ki
duridan: duri dan
žoqˤuža: žo qˤuža
buʎan: bu ʎa n
koʎun: koʎun
ideɣul: ide ɣul
boquxšeč: bo qu xšeč
boquxše: bo qu xše
urɣišeč: urɣišeč
bečbizaʎa: beč bi zaʎa
ħažiyawi: ħ a ži yaw i
gucač: guca č
gucbič: gucbič
yēⁿʎ: y ēⁿ ʎ
yiyоy: yi yо y
lezan: le za n
lhz: l h z
liyet: liye t
kandazaqal: kandazaqal
qitaha: qi ta ha
ɣebilʲan: ɣe bilʲa n
buʎxun: bu ʎ xun
erele: e re le
buʎuxšeso: bu ʎu xše so
exenamal: e xenamal
giłɣuli: gi ł ɣuli
yotuqqu: yo tuqqu
qodo: qodo
lakka: la k ka
exen: e xen
lahlunay: la h lunay
yekdlun: yekd lun
kutakʎa: ku ta k ʎa
bɨqˤ: bɨ qˤ
borʎidaʎa: bor ʎi daʎa
coda: coda
neʎi: ne ʎi
biyinso: biyin so
buwek: bu we k
yezunso: ye zun so
nartawla: nar taw la
dunnalʎali: dun nal ʎa li
øezunso: øe zun so
øiyin: øi yin
øotuqdowquł: øo tuq dow qu ł
beštin: be š tin
učitel: u či te l
øotuquč: øo tuqu č
ʎusuč: ʎusu č
koden: ko den
zamanač: zamana č
mokšehol: mo kše ho l
yiyin: yi yin
ʎuʎšeholuč: ʎu ʎše ho lu č
bekulšeholuč: be kul še ho lu č
gˤandu: gˤan du
yiqatehol: yi qate ho l
himonaban: himona ban
ʎolon: ʎolon
øotuqšeqa: øo tuqše qa
ičlaxšeqda: ičla xšeq da
bocdɣo: boc d ɣo
øuhšeqa: øu h še qa
guwecbo: gu we c bo
yoⁿkdšezuqdun: yoⁿ kd še zuq dun
uqdˤučdé: uq dˤ u č d é
ʎdunʎdol: ʎ dun ʎ dol
šari: šari
øeččuqarʎa: øeč čuqar ʎa
yusuqarʎa: yusuqar ʎa
hicate: hi cate
karawatɨʎ: karawatɨ ʎ
guccuqarʎa: gu c cuqar ʎa
kote: ko te
meqi: me qi
pamyatnik: pam yat ni k
bečzgɣul: beč z g ɣul
šaytan: šay ta n
bečzahali: beč za ha li
hatanʎal: hata n ʎa l
isisxa: isis xa
liča: liča
loqqa: lo q qa
giłil: gi łil
øeqʷaʎa: øe qʷaʎa
bexanin: be xanin
bekxun: be k xun
lʲuʎxa: lʲu ʎ xa
iseiseč: ise iseč
akalbič: a ka l bi č
yeⁿʎaluso: yeⁿ ʎa luso
eⁿduč: eⁿ du č
sasaqa: sasaqa
iʎʎuhol: iʎʎu ho l
homondu: ho mondu
qʷaki: qʷa ki
aoloqanba: a o lo qan ba
beqʷaʎeru: beqʷaʎeru
aʎazał: aʎa za ł
žokbo: žo k bo
lʲuʎxaʎeru: lʲu ʎ xaʎe ru
hobonelin: hobone lin
neʎdun: ne ʎ dun
ɣutuq: ɣu tuq
mižuqo: mižuqo
lotokun: lo to kun
hobotdun: hobo tdun
bułe: bu łe
øoⁿkdšezuqdun: øoⁿ kd še zuq dun
žahaʎda: ža haʎ da
liqqin: liq qin
nagah: na ga h
øeⁿʎa: øeⁿ ʎa
sanqisin: sa n qisin
gugaqan: gu gaqan
gulło: gul ło
aħmadil: aħmadil
biqa: bi qa
øiqše: øi qše
øusło: øus ło
bezzuło: be zzu ło
øoqa: øo qa
øeččuło: øeč ču ło
yeččuło: yeč ču ło
duduqe: duduqe
yakka: ya k ka
ciyoⁿ: ci yoⁿ
dahar: da har
čaʎi: čaʎi
čaʎło: čaʎ ło
roqbi: ro qbi
beqqoʎeru: be q qoʎe ru
arde: arde
giłɣužas: gi ł ɣužas
biqixłon: bi qi x łon
yešta: yeš ta
hodłon: ho d łon
yešutše: yešu tše
leqłon: leq łon
bexan: be xan
boqłon: bo q łon
boqbiłon: bo qbiłon
čorpa: č or pa
qˤuqˤles: qˤuqˤ le s
atɨn: atɨn
maqan: maqan
ɣoboɣoli: ɣo bo ɣoli
zebun: zebun
isuł: isu ł
ɣʷaden: ɣʷa den
liyey: liyey
ɣolʎoson: ɣolʎoson
ʎarmałin: ʎar ma łin
liʎin: liʎin
ʎarqa: ʎar qa
øoⁿkdoguk: øoⁿ kdo guk
ⁿʎusun: ⁿ ʎusun
golzaha: gol za ha
mesedon: mese don
yuxˤadun: yu xˤ a dun
šwannu: š wa n nu
buhun: bu hun
qˤuno: qˤuno
obutili: obutili
biʎqˤu: biʎ qˤu
obutii: obuti i
buxˤadi: bu xˤ adi
obutɨli: obutɨli
bɨʎqˤu: bɨ ʎ qˤu
bakʷaʎa: ba k ʷaʎa
huⁿnʎol: huⁿ n ʎol
lʲoʎše: lʲoʎše
оⁿčun: оⁿ čun
ʎiɣin: ʎi ɣin
bucu: bu cu
øuqun: øuqun
sabab: sa ba b
ħallamalaqe: ħallamalaqe
bečedaw: beče daw
øeqʷa: øe qʷa
xan: xan
liło: liło
šiʎin: š iʎin
muħamadin: mu ħ amadin
patimatɨn: pati matɨn
hadiyadɨl: hadi ya d ɨl
muħamadɨn: mu ħ ama d ɨn
hadiyadza: hadi ya d za
qʷiqʷinin: qʷi qʷinin
hadiyadzal: hadiyadzal
hadiyadzaɣal: hadi ya d za ɣal
kaat: ka at
hadiyadzaɣul: hadi ya d za ɣul
hadiyadzala: hadiyadzala
hadiyadzalaɣul: hadiyadzala ɣul
hadiyadzaɣa: hadi ya d za ɣa
kečibo: keči bo
hadiyadzaʎasa: hadi ya d zaʎasa
madiná: madin á
muradin: muradin
muħanadin: mu ħ a nadin
hadiyadɣa: hadi ya d ɣa
beccici: bec ci ci
iⁿyayin: iⁿ yayin
kadin: kadin
hadiyadzaqa: hadiyadzaqa
xerbon: xer bon
lecun: le cun
yaškaba: ya š kaba
hadiyadʎa: hadi ya d ʎa
qosun: qosun
hadiyadla: hadi ya d la
patimatin: pati matin
lekʷekun: le k ʷe kun
lagazaʎa: la ga zaʎa
codun: codun
kokun: kokun
xilʲlʲaʎa: xilʲ lʲaʎa
bahun: ba hun
istakanba: is ta ka n ba
hadiyadɨs: hadiyadɨs
xalhi: xa l hi
patimatqan: pati mat qan
muħamadqan: mu ħ ama d qan
suratba: surat ba
tuqˤalazaz: tuqˤ a la za z
yiči: yi či
bałaqu: ba łaqu
hadiyadil: hadi yadil
ɣˤʷebo: ɣˤ ʷe bo
haⁿhaⁿni: haⁿ haⁿ ni
ɣˤʷeza: ɣˤ ʷe za
hadiyadba: hadi ya d ba
aħmadi: aħmadi
hadiyadqa: hadi ya d qa
gollubo: gol lu bo
gollozuqo: gol lo zuqo
baccu: ba c cu
isin: isin
šarustan: šarus ta n
asiyat: asi yat
čorpałil: č or pa łil
nuʷatcegu: nu ʷat ce gu
mē: m ē
zihék: zi h é k
titi: ti ti
iseqé: iseq é
bazarʎazi: ba zar ʎa zi
nexeše: ne xe še
žl: ž l
ħaltidokše: ħal ti do kše
ɣodelʲso: ɣo de lʲ so
ayi: ayi
bakbi: ba k bi
dubuli: dubuli
asʲka: as ʲ ka
yiqbi: yi qbi
kbačun: k ba čun
bite: bi te
yakkunay: ya k kunay
ʎalixat: ʎa li xat
roqqu: ro qqu
onduč: ondu č
inžistar: in žis tar
yeⁿk: yeⁿ k
hedin: he din
yahukbi: ya huk bi
mо: m о
mačibók: ma či bók
gidík: gi d ík
lesse: le sse
uškurʎolúk: uš kur ʎol ú k
tukaʎalúk: tukaʎa l ú k
tamsák: tam s ák
usanše: usa n še
aqbák: aq b ák
ɣodék: ɣo d é k
zozzók: zo zz ók
łok: ło k
neqše: neqše
lacák: lac ák
xinkebók: xin ke bók
xicnobók: xi c no bók
xicnobo: xi c no bo
golík: gol ík
bešutdow: be šu tdow
iłeiłes: iłe iłe s
disertaciya: diser ta ci ya
mucnos: mu c nos
goqategu: goqate gu
calidi: calidi
hiboso: hi boso
muradi: muradi
na: na
muradɨl: muradɨl
øakʷi: øak ʷi
karavatʎa: kara v at ʎa
baħarayis: baħarayis
łiyo: łi yo
karimis: karimis
øołłu: øo ł łu
łeneʎo: łene ʎo
karimin: karimin
zaynabin: zay na bin
ʎarmazal: ʎar ma za l
loqnuʎo: lo q nu ʎo
obutɨl: obutɨl
bakʷi: bakʷi
naɣul: na ɣul
eⁿduli: eⁿ duli
šuʎšehol: šu ʎše ho l
tuʎík: tu ʎ ík
koro: koro
nalk: nal k
isxaʎa: is xaʎa
liyeqdbi: liyeq d bi
lakku: la k ku
inkar: in kar
bosun: bosun
godukanɨl: go duka n ɨl
bałgołi: ba ł go łi
litixxu: li ti xxu
luwoxxu: lu wo xxu
ʎaʎaqqu: ʎaʎaqqu
čdago: č da go
misedi: mise di
naz: na z
žohoz: žoho z
lołu: lo łu
ɣodow: ɣo dow
ɣobooqé: ɣo bo o q é
øečalu: øeča lu
ɣoɣu: ɣo ɣu
čoʎun: č oʎun
gugaʎa: gu gaʎa
yoⁿkalu: yoⁿkalu
loqa: lo qa
žoquzasa: žo qu zasa
lehelazas: le he la zas
soyró: soy r ó
iⁿdusa: iⁿ dusa
mallarasani: mal larasa ni
bočkama: bo č kama
buwoxun: bu wo xun
mallarasanɨs: mal larasa n ɨs
liqqi: liq qi
xitilbegi: xi til be gi
mon: mon
øesse: øe sse
bocqol: boc qo l
žikóʎo: ži k ó ʎo
ʎoloqayddu: ʎolo qay d du
amanatba: amanat ba
behideyk: be hide y k
hunuža: hunuža
pudí: pu d í
bociyu: boci yu
goʎa: goʎa
dubʎol: dub ʎol
ʎibalaqal: ʎiba laqa l
bacałakʷa: ba ca ła k ʷa
xˤux: xˤu x
hunižač: huni ža č
øuxle: øu x le
žequłič: žequłi č
xanus: xanus
wazirin: wa zi rin
yuxle: yu x le
diɣoɣul: di ɣo ɣul
yuqučé: yuqu čé
diɣoul: di ɣo ul
bati: bati
golik: goli k
užababi: užaba bi
uža: uža
lezbi: le z bi
оⁿčas: оⁿ čas
muč: mu č
beʎxun: be ʎ xun
sɨlaba: s ɨla ba
leʎše: leʎše
gugu: gu gu
yeʎše: ye ʎše
yukulše: yukul še
yukaʎa: yukaʎa
yahulše: ya hul še
bertinnoʎo: be r tin noʎo
